  ###########################
#  ##########################
## #################    #####
## ################# ## #####
## ##    ########### ## #####
## ## ## ########### ## #####
## ## ## ########### ## #####
## ## ## ########### ## #####
##    ## ########### ## #####
######## ########### ## #####
########                #####
########## ######## ### #####
########## ######## ### #####
########## ######## ### #####
########## ######## ### #####
########## ########     #####
########## ##################
########## ##########   #####
########## ########### ######
##########        #### ######
################# #### ######
################# #### ######
################# #### ######
################# #### ######
#################
#############################
#############################
#############################
#############################
#############################