  ############################
#  ###########################
## #################    ######
## ################# ## ######
## ##    ########### ## ######
## ## ## ########### ## ######
## ## ## ########### ## ######
## ## ## ########### ##      F
##                   #########
##############################